XXXXXXXMXXXXXXX
###############
XXXX#XXXX#XXXXX
###############
XXXXXXX#XXXX#XX
###############
#XXXXXXX#XXXXXX
###############
XXX#XXXXXXXXXX#
###############
XXXXXXXXXX##XXX
###############
XXXXXX#XXXXX#XX
###############
XXXXXXXXAXXXXXX